........................8
.........b......b.......8
.........a......a.......8
..b......a......e..b....8
..83...b.a.........a....0
..803.92.a...b.....a....0
..c44546.a..92.....a....8
.........a.d46.....a....8
.........a.........a....8
.........a.....b...a....0
.........e.....a...e....0
............b..83.......0
...93.......a..82.......8
..9003......a..c6.....910
..c4443.....a.........800
............a.........800

