.........c44446......c46.
...b.....................
..903............93......
..c443..........9047.....
..........93....c6......9
3........d443...........8
2...........83..........8
2...........82....93.....
2...........82....c6.....
6...........82...........
............c6...........
.....9157................
....902..................
....c4413...............9
.......c6...........91110
.............913....80000

