........................8
........................8
........................8
.................93.....8
..........93....902.....8
3........9003...802.....8
2........c006...c06.....8
02........c6.....e......8
003.....................8
0003....................8
00007...................8
0006....................8
002...............b.....8
046.............910113..8
2...............800002..8
2...............800000..8

